NO asset/wolfenstein/blue_stone.xpm
SO asset/wolfenstein/red_brick.xpm
EA asset/wolfenstein/grey_stone.xpm
WE asset/simonkraft/basalt_top.xpm


C 135, 206, 250
F 71, 71, 71

1111111111111111111111111
111100000001100000000000111
1011000001110000000000001
1001000000000000000000001
11111111101100000111000001
1000000000000000011101111111
11110111111111000000000010001
1111D111111111D11101010010001
11000000110101011100000010001
1000000000000000D000000000001
10000000000000001101010000001
11000001110101011111011110N01
11110111 1110101 101111010001
11111111 1111111 111111111111