NO asset/wolfenstein/blue_stone.xpm
SO asset/wolfenstein/red_brick.xpm
EA asset/wolfenstein/grey_stone.xpm
WE asset/simonkraft/basalt_top.xpm


C 135, 206, 250
F 71, 71, 71


11111111
10000001
10E00001
10101111
1000D001
10101111
10000001
11111111
