NO asset/wolfenstein/grey_stone.xpm
SO asset/wolfenstein/purple_stone.xpm
WE asset/wolfenstein/red_brick.xpm
EA asset/wolfenstein/wood.xpm

F 18,53,25
C 153,204,255

111111
1  0 1
1 1  1
1  N 1
111111
