







NO asset/test/north.xpm




        C 200,200,200




SO asset/test/south.xpm
                        WE asset/test/west.xpm
        EA asset/test/east.xpm
 
        F 20,           20,             20



11111
10001
10S01                
10001
10001
10001
11001               
10001
10001
10001111111
 1000      1  
1000111111111111   
11111           
