   WE                            asset/wolfenstein/grey_stone.xpm
NO      asset/wolfenstein/purple_stone.xpm



SO asset/wolfenstein/red_brick.xpm

F      17,    38,     64

EA asset/wolfenstein/wood.xpm



C 218, 234, 235



111111
100101
101001
1100N1
111111