NO ./texture/stone2.xpm
SO ./texture/brick.xpm
WE ./texture/stone1.xpm 
EA ./texture/basalt.xpm

F 220,100,0
C 225,30,0
    
    1    
   100   
  10N01  
 11111111111111111111
  