       1
      101
     10001
    100N001
   111111111