NO asset/test/north.xpm
SO asset/test/south.xpm
WE asset/test/west.xpm
EA asset/test/east.xpm

F 20,20,20
C 200,200,200

       



11111111111111
  1100N00001
   11000111
    110011
      100