NO asset/test/north.xpm
SO asset/test/south.xpm
WE asset/test/west.xpm
EA asset/test/east.xpm

F 20,20,20
C 200,200,200

       1111
      10000
     1000111
    100N00001
   111111111111
