NO asset/wolfenstein/grey_stone.xpm
SO asset/wolfenstein/purple_stone.xpm
WE asset/wolfenstein/red_brick.xpm
EA asset/wolfenstein/wood.xpm

F 1,1,1
C 225,30,0

        1111111111111111111111111
        1000000000110000000000001
     S  1011000001110000000000001
        1001000000000000000000001
111111111011000001110000000000001
100000000011000001110111111111111
11110111111111
11110111111111      
11000000110101      
10000000000000              
10000000000000001101010010001
1100000111010101111101111000111
11110111 1110101 101111010001
11111111 1111111 111111111111
